{
    "tiles": [
        [" "," "," "," "," "," "," "," "," "," "," "," "," "," "," "," "," "," "," "," "," "," "," "," "," "," "," "," "," "," "," "," "],
        [" ","F", "F", " ", " ", " ", " ", " ", " ", "E", " ", " ", " ", " ", " ", " ", " ", " ", " ", " ", " ", " ", " ", " ", " ", " ", " ", " ", " ", " "],
        [" ","F", "F", " ", " ", "P", " ", " ", " ", " ", " ", " ", " ", " ", " ", " ", " ", " ", " ", " ", " ", " ", " ", " ", " ", " ", " ", " ", " ", " "],
        [" ","F", "F", " ", " ", " ", " ", " ", " ", " ", " ", " ", " ", " ", " ", " ", " ", " ", " ", " ", " ", " ", " ", " ", " ", " ", " ", " ", " ", " "],
        [" ","F", "F", " ", " ", " ", "F", "F", " ", " ", " ", " ", "F", "F", " ", " ", " ", " ", " ", " ", " ", " ", " ", " ", " ", " ", " ", " ", " ", " "],
        [" ","F", "F", "F", "F", "F", "F", "F", "F", "F", "F", "F", "F", "F", " ", " ", " ", " ", "F", "F", " ", " ", " ", " ", " ", " ", " ", "F", "F", " "],
        [" ","F", "F", "F", "F", "F", "F", "F", "F", "F", "F", "F", "F", "F", " ", " ", " ", " ", "F", "F", " ", " ", " ", " ", " ", " ", " ", "F", "F", " "],
        [" "," ", "F", "F", "F", "F", "F", "F", "F", "F", "F", "F", "F", "F", "F", " ", " ", " ", "F", "F", "F", "F", " ", " ", " ", " ", " ", "F", "F", " "],
        [" "," ", "F", "F", "F", "F", "F", "F", "F", "F", "F", "F", "F", "F", "F", " ", " ", "F", "F", "F", "F", "F", " ", " ", " ", " ", " ", "F", "F", " "],
        [" "," ", "F", "F", "F", "F", "F", "F", "F", "F", "F", "F", "F", "F", "F", "F", "F", "F", "F", "F", "F", "F", "F", "F", " ", " ", " ", "F", "F", " "],
        [" "," ", "F", "F", "F", "F", "F", "F", "F", "F", "F", "F", "F", "F", "F", "F", "F", "F", "F", "F", "F", "F", "F", "F", " ", " ", " ", "F", "F", " "],
        [" "," ", "F", "F", "F", "F", "F", "F", "F", "F", "F", "F", "F", "F", "F", "F", "F", "F", "F", "F", "F", "F", "F", "F", " ", " ", " ", "F", "F", " "],
        [" "," ", "F", "F", "F", "F", "F", "F", "F", " ", " ", " ", " ", " ", " ", " ", "F", "F", "F", "F", "F", "F", "F", "F", " ", " ", " ", "F", "F", " "],
        [" "," ", "F", "F", "F", "F", " ", " ", " ", " ", " ", " ", " ", " ", " ", " ", " ", " ", "F", "F", "F", "F", "F", "F", " ", " ", " ", "F", "F", " "],
        [" "," ", "F", "F", "F", " ", " ", " ", " ", " ", " ", " ", " ", " ", " ", " ", " ", " ", " ", "F", "F", "F", "F", "F", " ", " ", " ", "F", "F", " "],
        [" "," ", "F", "F", "F", " ", " ", " ", " ", " ", " ", " ", " ", " ", " ", " ", " ", " ", " ", " ", "F", "F", "F", "F", " ", " ", " ", "F", "F", " "],
        [" "," ", "F", "F", "F", " ", " ", " ", " ", " ", " ", " ", " ", " ", " ", " ", " ", " ", " ", " ", " ", " ", " ", " ", " ", " ", " ", "F", "F", " "],
        [" "," ", "F", "F", " ", " ", " ", " ", " ", " ", " ", " ", " ", " ", " ", " ", " ", " ", " ", " ", " ", " ", " ", " ", " ", " ", " ", "F", "F", " "],
        [" "," ", "F", "F", " ", " ", " ", " ", " ", " ", " ", " ", " ", " ", " ", " ", " ", " ", " ", " ", " ", " ", " ", " ", " ", " ", " ", "F", "F", " "],
        [" "," ", "F", "F", " ", " ", " ", " ", " ", " ", " ", " ", " ", " ", "E", " ", " ", " ", "E", " ", " ", " ", "E", " ", " ", " ", " ", "F", "F", " "],
        [" "," ", "F", "F", "F", "F", " ", " ", " ", " ", "F", "F", "F", " ", " ", "", "F", "F", " ", " ", "F", "F", " ", " ", "F", "F", "F", "F", "F", " "],
        [" "," ", "F", "F", "F", "F", " ", " ", " ", " ", "F", "F", "F", " ", " ", "", "F", "F", " ", " ", "F", "F", " ", " ", "F", "F", "F", "F", "F", " "],
        [" "," ", "F", "F", "F", "F", " ", " ", " ", " ", "F", "F", "F", " ", " ", "", "F", "F", " ", " ", "F", "F", " ", " ", "F", "F", "F", "F", "F", " "],
        [" "," ", " ", "F", "F", "F", " ", " ", " ", " ", "F", "F", "F", "F", "F", "F", "F", "F", "F", "F", "F", "F", "F", "F", "F", "F", "F", "F", "F", " "],
        [" "," ", " ", "F", "F", "F", " ", " ", " ", " ", "F", "F", "F", "F", "F", "F", "F", "F", "F", "F", "F", "F", "F", "F", "F", "F", "F", "F", "F", " "],
        [" "," ", " ", "F", "F", "F", " ", " ", " ", " ", "F", "F", "F", " ", " ", " ", " ", " ", " ", " ", " ", " ", " ", " ", " ", " ", " ", "F", "F", " "],
        [" "," ", " ", "F", "F", "F", " ", " ", " ", " ", "F", "F", "F", " ", " ", " ", " ", " ", " ", " ", " ", " ", " ", " ", " ", " ", " ", "F", "F", " "],
        [" "," ", " ", "F", "F", "F", " ", " ", " ", " ", " ", " ", " ", " ", " ", " ", " ", " ", " ", " ", " ", " ", " ", " ", " ", " ", " ", "F", "F", " "],
        [" "," ", " ", "F", "F", " ", " ", " ", " ", " ", " ", " ", " ", " ", " ", "E", " ", " ", " ", " ", " ", " ", " ", " ", " ", " ", " ", "F", "F", " "],
        [" "," ", " ", "F", "F", " ", " ", " ", " ", " ", " ", " ", " ", " ", " ", " ", " ", " ", " ", " ", " ", " ", " ", " ", " ", " ", " ", "F", "F", " "],
        [" "," ", " ", "F", "F", " ", " ", " ", " ", " ", " ", " ", " ", " ", " ", " ", " ", " ", " ", " ", " ", " ", " ", " ", " ", " ", " ", "F", "F", " "],
        [" "," ", " ", "F", "F", " ", " ", " ", " ", " ", "F", "F", "F", " ", " ", " ", " ", " ", " ", " ", " ", " ", " ", " ", "V", " ", " ", "F", "F", " "],
        [" "," ", " ", "F", "F", "F", "F", "F", "F", "F", "F", "F", "F", "F", "F", "F", "F", "F", "F", "F", "F", "F", "F", "F", "F", "F", "F", "F", "F", " "],
        [" "," ", " ", "F", "F", "F", "F", "F", "F", "F", "F", "F", "F", "F", "F", "F", "F", "F", "F", "F", "F", "F", "F", "F", "F", "F", "F", "F", "F", " "],
        [" "," "," "," "," "," "," "," "," "," "," "," "," "," "," "," "," "," "," "," "," "," "," "," "," "," "," "," "," "," "," "," "]

    ]
}